00000000000100100000000000
00000000000100100000000000
00100300100000000100300100
00100300100000000100300100
00100300100011000100300100
00100300100011000100300100
00110000110033001100001100
00110000110033001100001100
00000001330011003310000000
00000001000011000010000000
00111000002211220000011100
00111000002211220000011100
00000000012222221000000000
00000000012222221000000000
33111100112222221100111133
33111100002222220000111133
33333300000022000000333333
00000000110022001100000000
00110000110000001100001100
00110000110000001100001100
00111000001100110000011100
00111000000000000000011100
00001100000000000000110000
00000000000111100000000000
00000000000144100000000000
00001100000144100000110000