00000000000000000000000000
00000000000000000000000000
00100100100000000100111122
00100100100000000100111122
00100100100011000100111122
00100100100011000100111122
00110000110033001100001122
00110000110033001100001122
00000001330011003310001122
00000001000011000010001122
00111000002211220000011122
00111000002211220000000000
00000000012222221000000000
00000000012233221000000000
11111100112233221100111133
11111100002222220000111133
11111100000022000000333333
00000000110022001100000000
11110000110000001100001100
11110000111111111100001100
11111000000000000000011100
11111000000000000000011111
00000000000000000000000000
00000000000111100000000000
00000000000144100000000011
00001100000144100000000000