00000000000000000000000000
00000000000000000000000000
33333333333333223332233322
33222222112222000000000000
33222222112222000000000000
33221100110033003333333300
33001100110033000000000000
33001100110033000000000000
33001100110033003333333300
33001100110033000000000000
33001100112233000000000000
33001100112233333333333333
33001100112222000000000000
33001100112222000000000000
33001122111111111111111122
33001122220000000000000000
33001122220000000000000000
33001111111111111111111111
33000000000000000000000000
33000000000000000022222222
33333333333333333333332222
22222220000000000000000222
22222200000000000000002222
22222000000111100000022222
22220000000144100000222222
22200000000144100002222222