00000000000000000000000000
00000000000000000000000000
11111111100000000111111111
11111111100000000111111111
11111111100000000111111111
11111111100000000111111111
11111111100033000111111111
11111111100000000111111111
11111111100000000111111111
11111111100000000111111111
11111111100000000111111111
11111111100000000111111111
11111111100000000111111111
11111111100000000111111111
11111111100000000111111111
11111111100000000111111111
11111111100000000111111111
11111111100000000111111111
11111111100033000111111111
11111111100000000111111111
11111111100000000111111111
33333330000000000003333333
33333300000000000000333333
33333000000111100000033333
33330000000144100000003333
33300000000144100000000333