00000000000000000000000000
00000000000000000000000000
00001110000000000001110000
11111111111111111111111111
00001110000000000001110000
00000000000000000000000000
00011110000000000000000000
00111111111111111111111111
01100000000000000000000111
10000000000000000000000111
00000111111111111100000111
00000111000000011100000111
00000111000000011100000111
00000111000000011100000111
00000111111111111100000111
00000000000000000000000111
00000000000000000000000111
00000000000000000001110111
00000000000000000000111111
00000000000000000000001111
00000000000000000000000111
00000000000000000000000000
00000000000000000000000000
00000000000111100000000000
00000000000144100000000000
00000000000144100000000000